#
# Map example for happyland
#

[options]
height = 11
width  = 25
background_color = 51,153,255

#
# Edges options specify how map edge are managed
# It can be solid or death, default is solid
#
edge_left   = SOLID
edge_right  = SOLID
edge_top    = SOLID
edge_bottom = DEATH

[tiles]
blocks1.wall_B_02   = C
blocks1.wall_A_01   = B
blocks1.roof_A_01   = A
blocks1.leftRoof_A  = 1
blocks1.rightRoof_A = 2

[map]
B,0,0,0,0,0,0,0,0,0,0,0,0,0,0,0,0,0,0,0,0,0,0,0,B
B,0,0,0,0,0,0,0,0,0,0,0,0,0,0,0,0,0,0,0,0,0,0,0,B
B,0,0,0,0,0,0,0,0,0,0,0,0,0,0,0,0,0,0,0,0,0,0,0,B
B,0,0,0,0,0,0,0,0,0,0,0,0,0,0,0,0,0,0,0,0,0,0,0,B
B,0,0,1,A,A,A,A,A,A,2,0,0,0,0,1,A,2,0,0,0,0,0,0,B
B,0,0,0,B,B,B,B,B,B,0,0,0,0,0,0,B,0,0,0,0,0,0,0,B
B,0,0,0,B,B,B,B,B,B,0,0,0,0,0,0,B,0,0,0,0,0,0,0,B
B,0,0,0,B,B,B,B,B,B,A,A,A,A,A,A,A,A,2,0,0,0,0,0,B
B,0,0,0,B,B,B,B,B,B,B,B,C,C,C,C,C,C,0,0,0,0,0,0,B
B,0,0,0,B,B,B,B,B,B,B,B,C,C,C,C,C,C,0,0,0,0,0,0,B
B,A,A,A,B,B,B,B,B,B,B,B,A,A,A,A,A,A,A,A,A,A,A,A,B

#
# Map layers :
#
# 0. Background not solid
# 1. Foreground not solid
# 2. Background solid
# 3. Foreground solid
# 4. Death
# 5. Ice
# 6. Exit
# 7. Door
# 8. Safe
# 9. Switch
# A. Swap
# B. Start
#
[map-layers]
2,0,0,0,0,0,0,0,0,0,0,0,0,0,0,0,0,0,0,0,0,0,0,0,2
2,0,0,0,0,0,0,0,0,0,0,0,0,0,0,0,0,0,0,0,0,0,0,0,2
2,0,0,0,0,0,0,0,0,0,0,0,0,0,0,0,0,0,0,0,0,0,0,0,2
2,0,0,0,0,0,0,0,0,0,0,0,0,0,0,0,0,0,0,0,0,0,0,0,2
2,0,0,2,2,2,2,2,2,2,2,0,0,0,0,2,2,2,0,0,0,0,0,0,2
2,0,0,0,2,1,1,1,1,1,0,0,0,0,0,0,1,0,0,0,0,0,0,0,2
2,0,0,0,1,1,1,1,1,1,0,0,0,0,0,0,1,0,0,0,0,0,0,0,2
2,0,0,0,1,1,1,2,2,2,2,2,2,2,2,2,2,2,2,0,0,0,B,0,2
2,0,0,0,2,1,1,1,1,1,1,1,0,0,0,0,0,0,0,0,0,0,0,0,2
2,0,0,0,2,1,1,1,1,1,1,1,0,0,0,0,0,0,0,0,0,0,0,0,2
2,2,2,2,2,2,2,2,2,2,2,2,2,2,2,2,2,2,2,2,2,2,2,2,2
